000000000000000
01##20000000000
1####2000000000
###############
###############